.#######.#############.#############.###.
#       #             #             #   #
# ##### # # # ####### # # ######### ### #
.O#     # # # #     # # # #       #   # #
.## ### # # ### ### ### # # ### ##### # #
#   #   # #   # # #     # # # #       # #
# ####### ### # # ####### # # ######### #
# #       # # #   #     # # #   #       #
# # ####### # ### # ### # # # # ##### # #
# #         #     #   #   #   #     # # #
# # ####### ######### ####.######## ### #
#   #   # # #       # #   #       #   # #
.#### # # # # ### ### # ### ### ##### # #
#     # #     #   #   #       #     #   #
# ##### ######.#### ### ####### # ##### #
# #   #       #   #   # #     # #     # #
# ### ####### # # # # ### ### ##### ### #
#           #   # # #     #   #     #   #
.########## ##### # ####### ### ##### ##.
#     # #   #   # #   #     # #     # # #
# ### # # ##### # ##### ##### # ### # # #
# #     #       # #  X#     #   # #   # #
# ##### ####### # # ### ### # ### ##### #
#   #   #     # #   #   #   #   #   #   #
# # # ### ### # ######### ##### ### # # #
# # # #   #   # #     #   #   #   #   # #
# # # ##### ### ### # # ### # ### ### # #
# # #     # #   #   #   #   #   #   # # #
# # ##### # # ### ##.#### ##.## ### ### #
# # #   # # # #   # #       #     #   # #
# # # ### # # ### # # ####### ### ### # #
# # #     # #     #       #   #     # # #
.## # ##### ########### ### ### ##### # #
#   # #     #         # #   # #   #   # #
# ### # ### # ####### ### ### # ### ### #
# #     #     #   #       #   # #   #   #
# # ####.#### # # ##### ##### # # ### # #
# # #   #   # # #     # #   #   #     # #
# ### # # # ### ##### ### # ########### #
#     #   #         #     #             #
.#####.###.#########.#####.#############.
